WWWWWWWWWWWWWWWWWWWWW
W.SSSSSSSSSSSSSW.OPKW
W...........P..W.WWWW
W.........SSSSSWWWWWW
WWWWWWWWWWWWWWWWWWWWW
W...................W
WI..................W
W...................W
W.............WWWWWWW
W.SS....P......G..LDW
W.............WWWWWWW
WWWWWWWWWWWWWWWWWWWWW