.....................
.....................
..WWWWW..............
..W...WWWWWW.........
..W.P......W.........
..W...WWWW.W..WWWWW..
..WWWWW..W.WWWW...W..
.........W......G.W..
.........WWWWWW...W..
..............WWWWW..
.....................
.....................