WWWWWWWWWWWWWWWWWWWWW
W...................W
W..W.W..WW..W...W...W
W...W..W..W.W...W...W
W...W..W..W.W...W...W
W...W...WW...WWW....W
W...................W
W.W.....W.W.WW..W...W
W..W.W.W..W.W.W.W...W
W...W.W...W.W..WW...W
WP.................GW
WWWWWWWWWWWWWWWWWWWWW