...WWW...............
...WDW.....WWWWWWW...
..WWSWW....W.....W...
..W...WWWWWW.D...W...
..W.G......W.....W...
..W...WWWW.W..WWWWW..
..WWWWW..W.WWWW...W..
...W.....W......P.W..
...W...D.WWWWWW...W..
...W.....W....WW.WW..
...WWWWWWW.....WDW...
...............WWW...