.WWWWW..WWWWW..WWWWW.
.W...W..W...W..W...W.
.W.K.W..W.G.W..W.I.W.
.W...W..W...W..W...W.
.WW.WW..WW.WW..WW.WW.
..W.WWWWWWOWWWWWWLW..
..W...............W..
..WWWWWWWW.WWWWWWWW..
........WW.WW........
........W...W........
........W.P.W........
........WWWWW........