WWWWWWWWWWWWWWWWWWWWW
WWDP....WWW.....K..WW
WWWWWWW.WWW.WWWWWW.WW
W.......WWW.WWWW...WW
W.WWWWWWWWW.WWWW.WWWW
W.W...WWWWW.WW.....WW
W.W.D.WG.L..WW.WWW.WW
W.W...WWWWWWWW.WWWKWW
W.WWWWWWWWWWWW.WWW.WW
W..................WW
WWWWWWWWWWWWWWWWWWWWW
WWWWWWWWWWWWWWWWWWWWW