WWWWWWWWWWWWWWWWWWWWW
W.........L.........W
W.I.......L.......P.W
W.........L.........W
WWWWWWWWWWWWWWWWWWWWW
W.........O.........W
W.P.......O.......G.W
W.........O.........W
WWWWWWWWWWWWWWWWWWWWW
W.P.................W
W.................K.W
WWWWWWWWWWWWWWWWWWWWW