WWWWWWWWWWWWWWWWWWWWW
W...................W
W.P...............G.W
W...................W
W...................W
WWWWWWWWWWWWWWWWWWWWW
WWWWWWWWWWWWWWWWWWWWW
W...................W
W...............SS..W
W.P.............SS..W
W...................W
WWWWWWWWWWWWWWWWWWWWW