WWWWWWWWWWWWWWWWWWWWW
WWWWWW..............W
WWPLDW..............W
WW.WWWWWWWWWWWWWWWWWW
WW.WP..K........GWWWW
WWIWWWWWWWWWWWWWWWWWW
WW.WWWWWWWWWWWWWWWWWW
WW.W...............PW
WW.W.WWWWWWWWWWWWWWOW
WW.WWW............WDW
WW.W..............WWW
WWWWWWWWWWWWWWWWWWWWW