WWWWWWWWWWWWWWWWWWWWW
W.S.SS.SSSW..S..S...W
W......G..WS......SSW
WS..SS.S.SW..S..S.S.W
W..S......WS........W
WS...SS...W..S...SS.W
W.....S...WS...S....W
W.SS..S..SW...SS..S.W
W...S...S.W.G.......W
W...SPS...W....P.S..W
W.........W....S....W
WWWWWWWWWWWWWWWWWWWWW