WWWWWWWWWWWWWWWWWWWWW
WSSSSSSSSSSSSSSSSSSSW
WS.K...P.S.K.SSSWWWWW
WS...........SS....GW
WS.K.......K.SS.WWWWW
WS...........SS.W...W
WS.K...K...K.SS.W...W
WS...........SS.W...W
WS...........SS.WWWWW
WS...........SSLW...W
WSSSSSSSSSSSSSLPW...W
WWWWWWWWWWWWWWWWWWWWW